//MAP CONVERTED BY dmm2tgm.py THIS HEADER COMMENT PREVENTS RECONVERSION, DO NOT REMOVE
"a" = (
/turf/closed/interior/tank/chaos/thirteen,
/area/interior/tank/chaos)
"b" = (
/obj/structure/bed/chair/vehicle_crew/gunner/chaos,
/turf/open/interior/tank/chaos/three,
/area/interior/tank/chaos)
"d" = (
/obj/structure/prop/chaos_tank/computer/front_center,
/turf/closed/interior/tank/chaos/fourteen,
/area/interior/tank/chaos)
"e" = (
/obj/structure/gun_breech/chaos,
/turf/open/interior/tank/chaos/five,
/area/interior/tank/chaos)
"f" = (
/turf/closed/interior/tank/chaos/eighteen,
/area/interior/tank/chaos)
"h" = (
/obj/structure/prop/chaos_tank/computer/front_left,
/turf/open/interior/tank/chaos/ten,
/area/interior/tank/chaos)
"i" = (
/turf/open/interior/tank/chaos/seven,
/area/interior/tank/chaos)
"m" = (
/turf/closed/interior/tank/chaos/fifteen,
/area/interior/tank/chaos)
"n" = (
/obj/structure/prop/chaos_tank/computer/front_right,
/turf/open/interior/tank/chaos/twelve,
/area/interior/tank/chaos)
"o" = (
/obj/structure/periscope/chaos,
/turf/open/interior/tank/chaos/four,
/area/interior/tank/chaos)
"q" = (
/obj/structure/prop/chaos_tank/computer/floating,
/obj/structure/prop/chaos_tank/computer/floating/alt,
/obj/structure/prop/chaos_tank/computer/gunner_console,
/turf/open/interior/tank/chaos/six,
/area/interior/tank/chaos)
"r" = (
/obj/structure/ammo_rack/primary/chaos,
/turf/closed/interior/tank/door/chaos,
/area/interior/tank/chaos)
"v" = (
/obj/structure/bed/chair/vehicle_crew/driver/chaos,
/turf/open/interior/tank/chaos/eleven,
/area/interior/tank/chaos)
"x" = (
/turf/open/interior/tank/chaos/two,
/area/interior/tank/chaos)
"B" = (
/turf/open/interior/tank/chaos/nine,
/area/interior/tank/chaos)
"D" = (
/turf/closed/interior/tank/chaos/seventeen{
	dir = 1
	},
/area/interior/tank/chaos)
"N" = (
/turf/closed/interior/tank/chaos/eighteen{
	dir = 1
	},
/area/interior/tank/chaos)
"U" = (
/turf/open/interior/tank/chaos/eight,
/area/interior/tank/chaos)
"V" = (
/obj/structure/ammo_rack/secondary/chaos,
/obj/structure/bed/chair/loader_seat/chaos,
/turf/open/interior/tank/chaos/one,
/area/interior/tank/chaos)
"X" = (
/turf/closed/interior/tank/chaos/nineteen,
/area/interior/tank/chaos)
"Z" = (
/turf/closed/interior/tank/chaos/seventeen,
/area/interior/tank/chaos)

(1,1,1) = {"
f
D
D
D
D
D
"}
(2,1,1) = {"
a
h
i
o
V
X
"}
(3,1,1) = {"
d
v
U
e
x
r
"}
(4,1,1) = {"
m
n
B
q
b
X
"}
(5,1,1) = {"
N
Z
Z
Z
Z
Z
"}
